TILEMAP
24 96 							-- Size of tile map in tiles
8 8 							-- Tile size & block size
images/blocks.png 	-- Tilesheet
12 6 								-- Number of tiles in tilesheet
========================
=VUVUVUV12121212UVUVabU=
=JIJIJIJ56565656IJIJmnI=
=V343434UVUVUVUV343434U=
=JcdabIJIJIJIJIJIJabcdI=
=VopmnUVUVUVUVUVUVmnopU=
=JcdababIJIJIJIJababcdI=
=VopmnmnUVUVUVUVmnmnopU=
=JcdcdcdIJIJIJIJcdcdcdI=
=VopopopUV3434UVopopopU=
====7878IJ7878IJ7878====
====3434UV3434UV3434====
=JabIJIJIJIJIJIJIJIJijI=
=Vmn34UVUVUVUVUVUV34uvU=
=J3434IJIJIJIJIJIJ3434I=
=VUVUVUVUVUVUVUVUVUVUVU=
=JIJIJIJIJIJIJIJIJIJIJI=
=VUVUVUVUVUVUVUVUVUVUVU=
=JIJIJIJIJIJIJIJIJIJIJI=
=VUVUVUVUVUVUVUVUVUVUVU=
=JIJIJIJIJIJIJIJIJIJIJI=
=VUVUVUVUVUVUVUVUVUVUVU=
=JIJIJIJIJIJIJIJIJIJIJI=
========UVUVUVUV========
========================
=VUVUVUVUVUVUVUVUVUVUVU=
=JIJIJIJIJIJIJIJIJIJIJI=
=V12UVUVUV9:9:UVUVUV12U=
=J12129:9:12129:9:1212I=
=VUVUVUVUVUVUVUVUVUVUVU=
=JIJIJIJIJ9:9:IJIJIJIJI=
=VUVUVUVUV9:9:UVUVUVUVU=
=JOPIJIJIJIJIJIJIJIJ78I=
=V[\UV343434343434UV78U=
=J56IJ9:IJ====IJ9:IJ56I=
=VUVUVUVUVUVUVUVUVUVUVU=
=JIJIJIJIJIJIJIJIJIJIJI=
=VUVUVUVUVUVUVUVUVUVUVU=
=JIJIJIJ56IJIJ56IJIJIJI=
=V56UVUVUVUVUVUVUVUV56U=
=JIJIJIJIJIJIJIJIJIJIJI=
=VUVUVUVUVUVUVUVUVUVUVU=
=JIJIJIJIJIJIJIJIJIJIJI=
=VUVUVUVUVUVUVUVUVUVUVU=
=JIJIJIJIJIJIJIJIJIJIJI=
=VUVUVUVUVUVUVUVUVUVUVU=
=JIJIJIJIJIJIJIJIJIJIJI=
========UVUVUVUV========
========================
=VUVUVUVUVUVUVUVUVUVUVU=
=JIJIJIJIJIJIJIJIJIJIJI=
=VUVUVUVUVUVUVUVUVUVUVU=
=J56121256121256121256I=
=VUVUVUVUVUVUVUVUVUVUVU=
=J12IJIJ12IJIJ12IJIJ12I=
=VUV5656UVUVUVUV5656UVU=
=JIJ3434IJ5656IJ3434IJI=
=V56OP34UV1212UV347856U=
=J56[\34IJ7878IJ347856I=
=VUV9:9:UVUVUVUV9:9:UVU=
=JIJ1212IJIJIJIJ1212IJI=
=VUV5656UVUVUVUV5656UVU=
=JIJIJIJIJIJIJIJIJIJIJI=
=VUVUVUVUVUVUVUVUVUVUVU=
=JIJIJIJIJIJIJIJIJIJIJI=
=VUVUVUVUVUVUVUVUVUVUVU=
=JIJIJIJIJIJIJIJIJIJIJI=
=VUVUVUVUVUVUVUVUVUVUVU=
=JIJIJIJIJIJIJIJIJIJIJI=
=VUVUVUVUVUVUVUVUVUVUVU=
=JIJIJIJIJIJIJIJIJIJIJI=
========UVUVUVUV========
========================
=VUVUVUVUVUVUVUVUVUVUVU=
=JIJIJIJIJOPIJIJIJIJIJI=
=VUVUVUVUV[\UVUVUVUVUVU=
=JIJ341212IJIJ121234IJI=
=V34UVUVUV1212UVUVUV34U=
=J34343434IJIJ34343434I=
=V56565656121256565656U=
=J56IJIJIJIJIJIJIJIJ56I=
=V56565656121256565656U=
=J78787878IJIJ78787878I=
=V78UVUVUV1212UVUVUV78U=
=JIJ781212IJIJ121278IJI=
=VUVUVUVUVUVUVUVUVUVUVU=
=JIJIJIJIJIJIJIJIJIJIJI=
=VUVUVUVUVUVUVUVUVUVUVU=
=JIJIJIJIJIJIJIJIJIJIJI=
=VUVUVUVUVUVUVUVUVUVUVU=
=J3434IJIJIJIJIJIJ3434I=
=V56UVUVUVUVUVUVUVUV56U=
=J7878IJIJIJIJIJIJ7878I=
=VUVUVUVUVUVUVUVUVUVUVU=
=JIJIJIJIJIJIJIJIJIJIJI=
========================
========UVUVUVUV========

